A00SSS0000B00000000000000
0w0wSw0w0w0w0w0w0w0w0w0w0
0000000000000000000000000
0w0w0w0w0wBw0w0w0w0w0w0w0
000000000SS00000000000000
0w0w0w0w0w0w0w0w0w0w0w0w0
0000000000000000000000000
0w0w0w0w0w0w0w0w0w0w0w0w0
0000000000000000000000000
0w0w0w0w0w0w0w0w0wBw0w0w0
00000000000000B0000000000
